   Depth            BFSolver                A(i)                A(c)           A(+{c,i})         A(+{c,i,4})    A(+{*{i,i},c,4})    A(+{*{s,s},c,4})A(+{*{B,B,s,s},c,4})A(+{*{B,B,a,a},c,4})             A(rand)
       0                    3                   0                   0                   0                   0                   0                   0                   0                   0                   0
       1                    9                   3                   3                   3                   3                   3                   3                   3                   3                   3
       2                   15                  20                   9                  20                  20                 150                 150                 652                 510                   9
       3                   27                  48                  16                  40                  40                 302                 302                 719                 613                  95
       4                   40                  84                  26                  61                  61                 669                 622                 814                 674                  96
       5                   60                  99                  39                  68                  68                 670                 623                 815                 675                  97
       6                   78                 126                  52                  83                  83                 676                 628                 816                 679                  54
       7                  101                 154                  66                  97                  97                 331                 331                 720                 680                  98
       8                  119                 156                  79                 101                 101                 680                 632                 817                 682                 100
       9                  140                 172                  92                 116                 116                 715                 666                 818                 683                1589
      10                  157                 209                 104                 130                 130                 723                 671                 819                 340                1661
      11                  176                 252                 115                 144                 144                 772                 706                 854                 684                1662
      12                  196                 261                 127                 156                 156                 773                 707                 855                 402                1664
      13                  224                 297                 141                 186                 186                 774                 708                 856                 541                1666
      14                  257                 395                 163                 256                 256                 775                 709                 857                 542                1674
      15                  310                 503                 185                 288                 288                 819                 751                 858                 619                1678
      16                  366                 650                 227                 396                 396                 833                 766                 870                 685                1679
      17                  449                 861                 265                 495                 495                 850                 789                 872                 690                1680
      18                  531                 874                 326                 503                 503                 874                 805                 886                 693                1681
      19                  645                1138                 374                 599                 594                 892                 823                 897                 697                1729
      20                  748                1359                 443                 666                 649                 896                 827                 898                 700                1731
      21                  876                1438                 498                 693                 667                 896                 827                 899                 704                1732
      22                  987                1723                 544                 739                 690                 900                 833                 900                 703                1733
      23                 1117                1897                 586                 741                 692                 986                 920                1002                 704                1734
      24                 1229                2062                 601                 803                 722                 995                 938                1003                 646                1688
      25                 1365                2234                 631                 818                 728                 999                 942                1006                 649                1689
      26                 1490                2364                 632                 926                 777                1002                 944                1005                 654                1690
      27                 1646                2344                 659                 927                 778                 909                 962                 905                 706                1691
      28                 1795                2378                 676                 934                 780                 911                 962                1007                 670                1692
      29                 1983                2367                 711                 928                 778                1013                 969                1011                 709                1693
      30                 2160                2386                 764                 903                 758                1036                 995                1023                 710                1695
      31                 2373                2402                 818                 939                 784                1042                1002                1027                 715                1697
      32                 2566                2408                 888                 945                 789                1044                1007                1032                 724                1699
      33                 2796                2370                 950                 965                 800                1051                1011                1033                 726                1703
      34                 3004                2387                1024                 973                 808                1057                1018                1038                 727                1706
      35                 3236                2398                1091                 961                 797                1058                1019                1039                 728                1735
      36                 3412                2405                1171                 972                 807                1059                1020                1040                 729                1737
      37                    0                2401                1231                 976                 811                1060                1021                1041                 730                1752
      38                    0                   0                1297                   0                   0                1062                1023                1043                 732                1753
      39                    0                   0                   0                   0                   0                1065                1026                1046                 736                1755
      40                    0                   0                   0                   0                   0                1069                1030                1050                 743                1756
      41                    0                   0                   0                   0                   0                1072                1033                1053                 745                1757
      42                    0                   0                   0                   0                   0                1077                1038                1055                 748                1759
      43                    0                   0                   0                   0                   0                1079                1040                1057                 753                1766
      44                    0                   0                   0                   0                   0                1082                1043                1060                 754                1773
      45                    0                   0                   0                   0                   0                1084                1045                1062                 756                1817
      46                    0                   0                   0                   0                   0                1009                 962                 996                 592                1822
      47                    0                   0                   0                   0                   0                1009                 966                 997                 665                1923
      48                    0                   0                   0                   0                   0                1017                 972                 998                 671                1926
      49                    0                   0                   0                   0                   0                1040                 998                 999                 667                1973
      50                    0                   0                   0                   0                   0                1021                1001                 971                 601                1977
      51                    0                   0                   0                   0                   0                1024                 979                 952                 666                1987
      52                    0                   0                   0                   0                   0                1050                1012                 955                 672                1988
      53                    0                   0                   0                   0                   0                1051                1013                 955                 673                1989
      54                    0                   0                   0                   0                   0                1049                1010                 956                 673                1962
      55                    0                   0                   0                   0                   0                1050                1011                 960                 609                1963
      56                    0                   0                   0                   0                   0                 893                 824                 972                 610                1965
      57                    0                   0                   0                   0                   0                 894                 825                 582                 612                1966
      58                    0                   0                   0                   0                   0                 895                 826                 460                 322                1968
      59                    0                   0                   0                   0                   0                 668                   0                 303                 323                1872
      60                    0                   0                   0                   0                   0                 710                   0                 304                 329                1873
      61                    0                   0                   0                   0                   0                 720                   0                 294                 330                1986
      62                    0                   0                   0                   0                   0                 721                   0                 305                 399                1987
      63                    0                   0                   0                   0                   0                 805                   0                 298                 334                1876
      64                    0                   0                   0                   0                   0                   0                   0                 299                 335                1878
      65                    0                   0                   0                   0                   0                   0                   0                 301                 337                1881
      66                    0                   0                   0                   0                   0                   0                   0                 278                 197                1917
      67                    0                   0                   0                   0                   0                   0                   0                 279                 198                1901
      68                    0                   0                   0                   0                   0                   0                   0                 280                 199                1990
      69                    0                   0                   0                   0                   0                   0                   0                 285                 204                1982
      70                    0                   0                   0                   0                   0                   0                   0                 288                 208                1995
      71                    0                   0                   0                   0                   0                   0                   0                 301                 337                2001
      72                    0                   0                   0                   0                   0                   0                   0                 319                 400                2003
      73                    0                   0                   0                   0                   0                   0                   0                   0                   0                2003
      74                    0                   0                   0                   0                   0                   0                   0                   0                   0                2004
      75                    0                   0                   0                   0                   0                   0                   0                   0                   0                2005
      76                    0                   0                   0                   0                   0                   0                   0                   0                   0                1582
      77                    0                   0                   0                   0                   0                   0                   0                   0                   0                1583
      78                    0                   0                   0                   0                   0                   0                   0                   0                   0                1434
      79                    0                   0                   0                   0                   0                   0                   0                   0                   0                1438
      80                    0                   0                   0                   0                   0                   0                   0                   0                   0                1440
      81                    0                   0                   0                   0                   0                   0                   0                   0                   0                1453
      82                    0                   0                   0                   0                   0                   0                   0                   0                   0                1454
      83                    0                   0                   0                   0                   0                   0                   0                   0                   0                1455
      84                    0                   0                   0                   0                   0                   0                   0                   0                   0                1456
      85                    0                   0                   0                   0                   0                   0                   0                   0                   0                1457
      86                    0                   0                   0                   0                   0                   0                   0                   0                   0                1451
      87                    0                   0                   0                   0                   0                   0                   0                   0                   0                1452
      88                    0                   0                   0                   0                   0                   0                   0                   0                   0                1567
      89                    0                   0                   0                   0                   0                   0                   0                   0                   0                1568
      90                    0                   0                   0                   0                   0                   0                   0                   0                   0                1569
      91                    0                   0                   0                   0                   0                   0                   0                   0                   0                1570
      92                    0                   0                   0                   0                   0                   0                   0                   0                   0                1266
      93                    0                   0                   0                   0                   0                   0                   0                   0                   0                1269
      94                    0                   0                   0                   0                   0                   0                   0                   0                   0                1288
      95                    0                   0                   0                   0                   0                   0                   0                   0                   0                1289
      96                    0                   0                   0                   0                   0                   0                   0                   0                   0                1330
      97                    0                   0                   0                   0                   0                   0                   0                   0                   0                1414
      98                    0                   0                   0                   0                   0                   0                   0                   0                   0                1416
      99                    0                   0                   0                   0                   0                   0                   0                   0                   0                1417
     100                    0                   0                   0                   0                   0                   0                   0                   0                   0                1418
     101                    0                   0                   0                   0                   0                   0                   0                   0                   0                1419
     102                    0                   0                   0                   0                   0                   0                   0                   0                   0                1420
     103                    0                   0                   0                   0                   0                   0                   0                   0                   0                1339
     104                    0                   0                   0                   0                   0                   0                   0                   0                   0                1309
     105                    0                   0                   0                   0                   0                   0                   0                   0                   0                1310
     106                    0                   0                   0                   0                   0                   0                   0                   0                   0                1311
     107                    0                   0                   0                   0                   0                   0                   0                   0                   0                1312
     108                    0                   0                   0                   0                   0                   0                   0                   0                   0                1313
     109                    0                   0                   0                   0                   0                   0                   0                   0                   0                1320
     110                    0                   0                   0                   0                   0                   0                   0                   0                   0                1322
     111                    0                   0                   0                   0                   0                   0                   0                   0                   0                1326
     112                    0                   0                   0                   0                   0                   0                   0                   0                   0                1327
     113                    0                   0                   0                   0                   0                   0                   0                   0                   0                1325
