   Depth            BFSolver                A(i)                A(c)           A(+{c,i})         A(+{c,i,4})    A(+{*{i,i},c,4})    A(+{*{s,s},c,4})A(+{*{B,B,s,s},c,4})A(+{*{B,B,a,a},c,4})             A(rand)
       0                    3                   0                   0                   0                   0                   0                   0                   0                   0                   0
       1                    6                   3                   3                   3                   3                   3                   3                   3                   3                   3
       2                   11                   6                   6                   6                   6                   6                   6                   6                   6                   5
       3                   16                  17                  12                  14                  14                  22                   8                   8                   8                   6
       4                   23                  32                  18                  20                  20                  23                  11                  11                  11                   7
       5                   30                  63                  25                  30                  30                  25                  12                  12                  12                   8
       6                   39                  46                  24                  26                  26                  26                  13                  13                  13                  10
       7                   47                  41                  26                  25                  25                  15                  15                  15                  15                 189
       8                   57                  67                  25                  29                  29                  27                  16                  16                  16                 190
       9                   72                  69                  28                  31                  31                  19                  19                  19                  19                 192
      10                   99                 104                  33                  33                  33                  32                  21                  21                  21                5936
      11                  129                 199                  40                  46                  46                  51                  26                  26                  26                5937
      12                  174                 311                  50                  73                  73                  53                  28                  28                  28                5938
      13                  223                 516                  61                 138                 135                  56                  31                  31                  31                6305
      14                  296                 673                  79                 218                 214                  58                  33                  33                  33                6243
      15                  367                 976                 109                 346                 335                 915                  37                  37                  37                6246
      16                  465                1075                 137                 383                 371                 960                  59                  39                  39                6247
      17                  558                1428                 179                 533                 517                 963                  62                  41                  41                6249
      18                  698                1929                 209                 779                 755                 965                  79                  45                  45                6250
      19                  835                2212                 289                 877                 851                 967                  78                  54                  54                6252
      20                 1026                2899                 359                1075                 962                 970                  87                  55                  55                6185
      21                 1203                3202                 497                1435                 991                 493                  88                  55                  55                6186
      22                 1456                3586                 584                1559                1287                 499                  94                  61                  61                6187
      23                 1676                3759                 763                1592                1426                 501                  96                  63                  63                6190
      24                 1990                4537                 870                1884                1705                 504                  99                  66                  66                6214
      25                 2257                5372                1085                2151                2084                 725                 100                 444                 451                6215
      26                 2616                5881                1168                2496                2449                 757                 103                 443                 452                6200
      27                 2906                5883                1459                2860                2820                 758                 393                 444                 453                6217
      28                 3294                5900                1583                2318                2271                 603                 637                 445                 454                6304
      29                 3610                5851                1840                2775                2728                 841                 439                 445                 891                6249
      30                 3990                5902                1867                2889                2849                 902                 460                 446                 457                6228
      31                 4257                5929                2084                3065                3025                 796                 485                 447                 458                6234
      32                 4579                5943                2151                3068                3028                 797                 486                 448                 459                6292
      33                 4834                5938                2328                3123                3078                 800                 489                 800                 894                6269
      34                 5176                5948                2396                3138                3093                 973                 545                 805                 908                6272
      35                 5427                5848                2690                3126                3081                 807                 545                 573                 907                6279
      36                 5722                5850                2779                3142                3097                 815                 546                 813                 915                6280
      37                 5930                5857                3133                3153                3108                 817                 554                 812                 918                6292
      38                 6173                5766                3165                3142                3097                 821                 554                 818                 922                6279
      39                 6325                   0                3215                3171                3113                 828                 587                 819                 942                6281
      40                 6482                   0                3240                3126                3068                 830                 591                 824                 948                6283
      41                 6579                   0                3069                3120                3070                 834                 593                 828                 953                6287
      42                 6680                   0                3072                3119                3074                 785                 617                 837                 954                6291
      43                 6741                   0                2839                3168                3110                 790                 616                 860                 958                6292
      44                 6788                   0                2817                3172                3114                 842                 633                 874                 958                6293
      45                 6812                   0                2758                3159                3101                 905                 641                 879                 992                6270
      46                 6819                   0                2765                3123                3065                 913                 644                 882                1001                6293
      47                    0                   0                2742                3120                3062                 922                 645                 883                1002                6306
      48                    0                   0                   0                   0                   0                 953                 648                 886                1005                6179
      49                    0                   0                   0                   0                   0                 976                 651                 889                1008                6294
      50                    0                   0                   0                   0                   0                 978                 653                 891                1010                6182
      51                    0                   0                   0                   0                   0                 981                 691                 895                1014                6300
      52                    0                   0                   0                   0                   0                 983                 674                 924                1043                6302
      53                    0                   0                   0                   0                   0                1021                 693                 926                1045                6304
      54                    0                   0                   0                   0                   0                1004                 689                 930                1049                6306
      55                    0                   0                   0                   0                   0                1023                 690                 939                1058                6307
      56                    0                   0                   0                   0                   0                1019                 691                 939                1058                6132
      57                    0                   0                   0                   0                   0                1020                 706                 941                1060                6134
      58                    0                   0                   0                   0                   0                1021                 708                 943                1062                6305
      59                    0                   0                   0                   0                   0                1036                 711                 946                1065                6306
      60                    0                   0                   0                   0                   0                1038                 712                 947                1066                6307
      61                    0                   0                   0                   0                   0                1041                 714                 949                1068                6309
      62                    0                   0                   0                   0                   0                1042                 715                 950                1069                6310
      63                    0                   0                   0                   0                   0                1044                 716                 951                1070                6305
      64                    0                   0                   0                   0                   0                1045                   0                 696                 658                6306
      65                    0                   0                   0                   0                   0                1046                   0                 730                 692                6122
      66                    0                   0                   0                   0                   0                   0                   0                   0                   0                6294
      67                    0                   0                   0                   0                   0                   0                   0                   0                   0                6299
      68                    0                   0                   0                   0                   0                   0                   0                   0                   0                6297
      69                    0                   0                   0                   0                   0                   0                   0                   0                   0                6300
      70                    0                   0                   0                   0                   0                   0                   0                   0                   0                6150
      71                    0                   0                   0                   0                   0                   0                   0                   0                   0                6152
      72                    0                   0                   0                   0                   0                   0                   0                   0                   0                6155
      73                    0                   0                   0                   0                   0                   0                   0                   0                   0                6156
      74                    0                   0                   0                   0                   0                   0                   0                   0                   0                6266
      75                    0                   0                   0                   0                   0                   0                   0                   0                   0                6267
      76                    0                   0                   0                   0                   0                   0                   0                   0                   0                6306
      77                    0                   0                   0                   0                   0                   0                   0                   0                   0                6307
      78                    0                   0                   0                   0                   0                   0                   0                   0                   0                6301
      79                    0                   0                   0                   0                   0                   0                   0                   0                   0                6304
      80                    0                   0                   0                   0                   0                   0                   0                   0                   0                6305
      81                    0                   0                   0                   0                   0                   0                   0                   0                   0                6307
      82                    0                   0                   0                   0                   0                   0                   0                   0                   0                6310
      83                    0                   0                   0                   0                   0                   0                   0                   0                   0                6311
      84                    0                   0                   0                   0                   0                   0                   0                   0                   0                6256
      85                    0                   0                   0                   0                   0                   0                   0                   0                   0                6253
      86                    0                   0                   0                   0                   0                   0                   0                   0                   0                6273
      87                    0                   0                   0                   0                   0                   0                   0                   0                   0                6276
      88                    0                   0                   0                   0                   0                   0                   0                   0                   0                6278
      89                    0                   0                   0                   0                   0                   0                   0                   0                   0                6281
      90                    0                   0                   0                   0                   0                   0                   0                   0                   0                6298
      91                    0                   0                   0                   0                   0                   0                   0                   0                   0                6283
      92                    0                   0                   0                   0                   0                   0                   0                   0                   0                6284
      93                    0                   0                   0                   0                   0                   0                   0                   0                   0                6285
      94                    0                   0                   0                   0                   0                   0                   0                   0                   0                6286
      95                    0                   0                   0                   0                   0                   0                   0                   0                   0                6289
      96                    0                   0                   0                   0                   0                   0                   0                   0                   0                6297
      97                    0                   0                   0                   0                   0                   0                   0                   0                   0                6307
      98                    0                   0                   0                   0                   0                   0                   0                   0                   0                6308
      99                    0                   0                   0                   0                   0                   0                   0                   0                   0                6299
     100                    0                   0                   0                   0                   0                   0                   0                   0                   0                6302
     101                    0                   0                   0                   0                   0                   0                   0                   0                   0                6305
     102                    0                   0                   0                   0                   0                   0                   0                   0                   0                6304
     103                    0                   0                   0                   0                   0                   0                   0                   0                   0                6063
     104                    0                   0                   0                   0                   0                   0                   0                   0                   0                6064
     105                    0                   0                   0                   0                   0                   0                   0                   0                   0                6066
